1111111111111111111
1000000000000000001
100000P000000000001
1000000000000000001
1000000000000000001
1000000000000000001
1011111111111111111
100000000001C000001
1000000000010000001
1000000000000000001
100000E111110000001
1000010000000000001
1111111111111111111